#### ########    #### ########       ###    #### ##    ## #### ########    ########  ########   #######  ##    ## ######## 
 ##  ##           ##     ##         ## ##    ##  ###   ## ####    ##       ##     ## ##     ## ##     ## ##   ##  ##       
 ##  ##           ##     ##        ##   ##   ##  ####  ##  ##     ##       ##     ## ##     ## ##     ## ##  ##   ##       
 ##  ######       ##     ##       ##     ##  ##  ## ## ## ##      ##       ########  ########  ##     ## #####    ######   
 ##  ##           ##     ##       #########  ##  ##  ####         ##       ##     ## ##   ##   ##     ## ##  ##   ##       
 ##  ##           ##     ##       ##     ##  ##  ##   ###         ##       ##     ## ##    ##  ##     ## ##   ##  ##       
#### ##          ####    ##       ##     ## #### ##    ##         ##       ########  ##     ##  #######  ##    ## ######## 
########   #######  ##    ## #### ########    ######## #### ##     ##    #### ######## 
##     ## ##     ## ###   ## ####    ##       ##        ##   ##   ##      ##     ##    
##     ## ##     ## ####  ##  ##     ##       ##        ##    ## ##       ##     ##    
##     ## ##     ## ## ## ## ##      ##       ######    ##     ###        ##     ##    
##     ## ##     ## ##  ####         ##       ##        ##    ## ##       ##     ##    
##     ## ##     ## ##   ###         ##       ##        ##   ##   ##      ##     ##    
########   #######  ##    ##         ##       ##       #### ##     ##    ####    ##    
