######## ##     ## ########     ######     ###    ##    ## ########    ####  ######        ###       ##       #### ######## 
   ##    ##     ## ##          ##    ##   ## ##   ##   ##  ##           ##  ##    ##      ## ##      ##        ##  ##       
   ##    ##     ## ##          ##        ##   ##  ##  ##   ##           ##  ##           ##   ##     ##        ##  ##       
   ##    ######### ######      ##       ##     ## #####    ######       ##   ######     ##     ##    ##        ##  ######   
   ##    ##     ## ##          ##       ######### ##  ##   ##           ##        ##    #########    ##        ##  ##       
   ##    ##     ## ##          ##    ## ##     ## ##   ##  ##           ##  ##    ##    ##     ##    ##        ##  ##       
   ##    ##     ## ########     ######  ##     ## ##    ## ########    ####  ######     ##     ##    ######## #### ######## 
